6 6 6 1 5 0 5 1
6 6 1 5 0 0 5 1
6 6 5 0 0 5 1 1
6 5 0 0 5 1 1 1
5 0 0 5 1 1 1 2
0 0 5 1 2 2 2 1
5 5 1 2 2 1 1 1
1 2 1 2 1 1 2 1

