0 0 0 0 4 5 5 1
0 5 5 5 5 1 1 1
0 0 0 5 5 1 1 2
0 0 0 0 0 5 2 2
0 0 0 0 0 0 1 1
0 0 0 0 1 1 6 2
0 0 0 0 1 6 6 6
0 0 5 0 0 1 1 2

